0 0 0 0 0 0 0 0 0 0 0 1 23 23 23 8 23 23 23 6 23 23 23 23 23 
0 0 0 11 11 11 11 11 11 11 11 13 0 0 0 1 0 0 0 1 0 0 0 0 0 
23 23 3 0 0 0 0 0 0 0 0 0 0 0 0 0 0 0 0 0 0 0 0 0 0 
11 11 11 11 11 11 11 11 11 2 11 11 11 11 11 11 11 11 11 11 11 11 11 11 0 
0 0 0 0 0 0 0 0 0 0 0 0 0 0 0 0 0 0 0 0 0 0 0 0 4 
0 11 11 11 11 11 11 2 11 11 11 11 11 11 11 11 11 11 11 11 11 11 11 11 11 
3 0 0 0 0 0 0 0 0 0 0 0 0 0 0 0 0 0 0 0 0 0 0 0 0 
11 11 11 11 11 11 11 11 11 2 11 11 11 11 11 11 11 11 11 11 11 11 11 11 0 
0 0 0 0 0 0 0 0 0 0 0 0 0 0 0 0 0 0 0 0 0 0 0 0 4 
0 11 11 11 11 11 11 11 11 11 11 2 11 11 11 11 11 11 11 11 11 11 11 11 11 
3 0 0 0 0 0 0 0 0 0 0 0 0 0 0 0 0 0 0 0 0 0 0 0 0 
11 11 11 11 11 11 11 11 11 11 11 11 11 2 11 11 11 11 11 11 11 11 11 11 0 
0 0 0 0 0 0 0 0 0 0 0 0 0 0 0 0 0 0 0 0 0 0 0 0 4 
23 23 9 11 11 11 11 11 11 11 11 11 11 11 11 2 11 11 11 11 11 11 0 0 0 
23 23 23 23 23 23 23 23 23 23 23 23 23 23 23 23 23 23 23 7 23 23 5 23 23 
-1 -1 0
