6 0 0 0 0 0 0 0 15 0 0 0 0 0 0 0 0 0 0 0 0 0 0 0 0 
0 0 0 0 0 0 0 0 15 0 0 0 0 0 0 0 0 0 0 0 0 1 0 0 0 
0 0 0 0 0 0 0 0 15 0 0 0 0 0 1 0 0 0 0 0 0 1 0 0 0 
3 0 0 0 0 0 7 0 15 0 0 0 0 0 12 0 0 0 0 0 0 5 9 16 16 
0 1 0 0 0 0 0 0 15 0 0 0 0 0 12 0 0 0 0 0 0 0 0 0 0 
0 1 0 0 1 0 0 0 15 0 0 0 0 1 12 0 0 0 0 0 0 0 0 0 0 
0 1 0 0 2 0 0 0 15 0 0 0 0 12 0 0 0 0 0 0 0 0 0 0 0 
0 0 1 0 0 0 0 0 15 0 0 0 0 12 0 3 1 1 1 1 1 1 1 1 1 
0 0 1 0 0 0 0 0 15 0 0 0 1 12 0 8 11 11 11 11 11 11 11 11 11 
0 0 2 0 0 0 0 0 15 0 0 0 12 0 0 1 0 0 0 0 0 0 0 0 0 
15 15 15 15 15 15 15 15 15 0 0 0 12 0 0 1 0 0 0 0 0 0 0 0 0 
11 11 11 11 0 0 0 0 0 0 0 1 12 0 0 1 0 0 0 0 0 0 0 0 0 
0 0 0 11 0 0 0 1 0 0 0 12 0 0 0 1 0 0 0 0 0 0 0 0 0 
0 0 0 11 0 0 0 0 0 0 0 12 0 0 0 1 0 0 0 0 0 0 0 0 0 
16 16 16 11 0 16 16 16 16 0 0 12 0 0 0 1 0 0 0 0 0 0 0 0 0 
-1 -1 0
