0 0 0 0 0 0 0 0 0
0 0 0 0 0 0 0 0 0
0 0 0 0 0 0 0 7 0
25 0 0 25 25 25 25 0 25

0 0 0 0 0 0 0 0 0
0 0 0 0 0 0 0 0 0
0 0 0 0 0 0 0 1 0
27 0 0 27 27 27 36 27 27

0 0 0 0 0 28 0 0 0
0 0 0 1 0 28 0 0 0
0 0 0 0 4 28 0 6 0
28 0 0 28 28 28 28 7 28

0 0 0 0 0 0 0 0 0 
0 0 0 0 0 0 0 0 0 
0 0 0 0 0 0 0 0 0 
21 0 0 16 19 16 19 36 16

0 0 0 0 0 0 0 0 2
1 1 0 0 0 0 0 0 0 
1 1 0 0 0 0 0 7 0
26 3 26 26 26 26 26 26 26

0 0 0 0 0 0 16 0 0 
0 0 0 0 0 0 16 0 0 
0 0 0 0 0 0 16 7 1 
30 0 0 30 14 30 30 30 30

0 0 29 0 0 0 0 0 20
0 0 29 0 0 0 0 0 20
4 0 29 1 0 0 0 6 20
29 0 29 29 29 29 29 29 29

0 0 0 0 0 0 0 0 0
0 0 0 0 0 1 0 0 0
0 0 0 0 0 9 6 0 0
29 0 29 29 29 29 7 16 16

0 0 0 0 0 0 0 0 0
0 0 0 0 0 0 0 0 0
6 0 0 0 0 0 0 6 0
29 0 8 0 0 0 0 7 0

20 5 0 0 0 0 0 6 20
20 0 0 0 0 0 0 0 20
20 0 0 16 16 16 0 0 20
20 0 0 16 16 16 0 0 20

0 0 0 1 0 0 0 6 0
0 0 0 20 0 0 0 0 0
0 0 0 20 0 0 0 7 0
29 0 0 20 29 29 1 29 29

0 0 0 0 0 0 6 0 1
0 0 0 0 0 0 0 0 0
0 0 0 0 0 0 0 0 0
19 0 0 19 19 19 19 7 19

0 1 0 0 0 0 0 0 0 
0 0 0 0 0 0 6 0 0
0 0 0 0 0 0 0 0 0
28 7 28 28 28 28 0 0 28 

20 0 0 0 0 0 0 0 0
20 0 0 0 0 0 0 0 1
20 6 0 0 0 0 0 0 0
32 32 32 32 32 32 0 0 32

0 19 0 0 0 0 0 0 0 
0 0 19 0 0 0 0 0 0
0 0 0 19 0 0 0 0 0 
17 18 18 18 0 0 0 17 0

0 1 0 0 0 0 0 0 0
0 0 6 0 0 0 0 0 0
0 0 0 0 0 0 0 0 0
0 7 0 0 0 0 0 0 34

0 0 0 0 0 0 0 5 1
0 0 0 0 0 20 0 0 20
0 0 0 0 0 20 0 0 16
25 36 25 25 25 20 0 0 20

0 0 0 0 0 0 0 0 0
0 0 0 0 0 1 0 0 0
0 0 0 0 0 0 0 0 0
0 36 0 0 0 0 0 0 34

 1 0 0 0 0 0 0 0 0
 1 0 0 0 1 0 0 0 0
 6 0 0 0 0 0 0 0 0
19 7 19 16 16 38 29 0 29

0 0 0 0 0 0 0 0 0
0 0 0 0 0 0 0 0 0
0 6 0 0 0 1 0 0 0
43 7 41 43 42 41 0 0 29

0 0 0 0 0 0 0 0 0
0 0 0 0 0 0 0 0 0
6 1 1 0 0 0 0 0 38
19 7 7 19 19 19 0 0 29

0 1 0 0 0 0 0 2 38
0 0 0 0 0 0 0 0 0
0 7 6 0 0 0 0 0 0
29 29 29 29 29 29 29 3 16

0 0 0 0 0 0 0 0 0
0 0 0 0 0 0 0 0 0
0 6 0 0 0 0 0 0 0
0 7 0 0 0 0 18 17 29

0 0 0 0 0 0 0 0 0
0 0 0 0 0 0 0 0 0
6 0 0 0 0 0 0 0 0
16 7 16 16 16 16 34