5 0 0 0 12 0 0 0 0 0 0 0 0 0 0 0 0 0 0 0 0 0 0 0 0 
12 0 0 1 12 0 0 0 0 0 0 19 19 0 0 0 19 19 0 0 0 0 0 0 0 
12 0 0 0 12 0 0 0 0 0 19 6 1 19 0 19 1 8 19 0 0 0 0 0 0 
12 1 0 0 12 0 0 0 0 19 1 1 1 1 19 1 1 1 1 19 0 0 0 0 0 
12 0 0 0 12 0 0 0 0 19 1 1 1 1 1 1 1 1 1 19 0 0 0 0 0 
12 0 0 1 12 0 0 0 0 19 1 1 1 1 1 1 1 1 1 19 0 0 0 0 0 
12 0 0 0 12 0 0 0 0 0 19 1 1 1 1 1 1 1 19 0 0 0 0 0 0 
12 1 0 0 12 0 0 0 0 0 0 19 1 1 1 1 1 19 0 0 0 0 0 0 0 
12 0 0 0 12 0 0 0 0 0 0 0 19 1 1 1 19 0 0 0 0 0 0 0 0 
12 0 0 1 12 0 0 0 0 0 0 0 0 19 1 19 0 0 0 0 0 0 0 0 0 
12 0 0 0 12 0 0 0 0 0 0 0 0 0 19 0 0 0 0 0 0 0 0 0 0 
12 1 0 0 12 0 0 0 0 0 0 0 0 0 0 0 0 0 0 0 0 0 0 0 19 
12 0 0 0 12 0 0 0 0 0 0 0 0 0 0 0 0 0 0 0 0 0 0 0 19 
12 0 0 1 12 7 0 1 1 1 0 1 1 1 0 1 1 1 0 1 1 1 0 0 19 
19 19 0 0 19 19 19 11 11 11 19 11 11 11 19 11 11 11 19 11 11 11 19 19 19 
-1 -1 0
