0 0 0 0 0 0 0 0 0 0 0 0 0 0 0 0 0 0 0 0 0 0 0 0 11 
0 0 0 0 0 0 0 16 16 16 16 16 16 16 16 16 16 16 16 16 16 0 0 0 0 
0 0 0 0 0 0 0 16 10 1 1 1 1 1 1 1 1 1 1 1 1 9 27 27 27 
0 20 13 0 20 0 0 16 16 1 16 16 1 16 16 1 16 16 1 16 16 0 0 0 0 
0 20 0 0 20 0 0 0 0 0 0 0 0 0 0 0 0 0 0 0 0 0 0 0 0 
1 20 0 1 20 1 0 0 0 10 0 0 10 0 0 10 0 0 12 0 0 0 0 0 0 
0 20 0 0 20 0 0 0 0 0 0 0 0 0 0 0 0 0 0 0 0 0 0 0 0 
0 20 1 0 20 0 0 0 0 0 0 0 0 0 0 0 0 0 0 0 0 0 0 0 0 
1 20 0 0 20 1 0 0 0 0 0 0 0 0 0 0 0 0 0 0 0 0 0 0 0 
0 20 0 1 20 0 0 0 0 0 0 0 0 0 0 0 0 0 0 0 0 0 0 0 0 
0 20 0 0 20 0 0 0 0 1 0 0 0 1 0 0 1 0 0 0 0 0 0 0 0 
1 20 0 0 20 1 0 0 0 0 0 0 0 0 0 0 0 0 0 0 0 0 0 0 0 
0 0 0 0 0 33 0 0 0 0 0 0 0 0 0 0 0 0 0 0 0 0 0 0 0 
0 0 0 0 0 0 0 0 0 0 0 0 0 0 0 0 0 0 0 0 0 0 0 0 0 
0 0 0 0 0 0 0 0 0 0 0 0 0 0 0 0 0 0 0 0 0 0 0 0 0 
22 0 0
