0 0 0 0 0 0 0 0 0 0 0 0 0 0 0 0 0 0 0 0 0 0 0 0 0 
0 0 0 0 0 0 0 0 0 0 0 0 0 0 0 0 0 0 0 0 0 0 0 0 0 
0 0 0 0 0 0 0 0 0 16 0 0 0 0 0 0 16 0 0 11 0 0 0 0 0 
0 0 0 0 0 0 0 0 0 16 0 0 0 0 0 0 16 0 0 0 0 0 0 0 0 
0 0 0 0 0 0 30 30 16 16 13 0 0 0 0 0 16 0 0 30 30 0 0 0 0 
0 0 0 0 0 0 16 0 0 0 0 0 0 0 0 0 16 0 0 16 16 5 0 0 0 
0 0 0 0 0 0 16 0 0 0 0 0 0 0 12 0 0 0 0 16 0 0 0 0 0 
0 0 0 0 0 0 16 0 0 0 0 0 0 0 0 0 0 0 0 16 0 0 0 0 0 
0 0 0 0 0 0 16 0 0 0 0 0 0 0 0 0 0 6 0 16 0 0 30 30 30 
0 0 0 0 0 0 16 0 0 0 37 0 0 0 0 0 0 0 0 16 0 0 19 1 30 
0 0 0 0 0 0 16 0 0 0 0 0 0 0 0 0 16 0 0 20 0 0 30 30 30 
0 0 0 0 0 0 20 0 0 0 0 0 0 0 7 0 0 0 0 20 0 0 0 0 0 
0 0 0 0 0 0 0 0 0 0 0 0 0 0 0 0 0 0 0 0 0 0 0 0 0 
20 5 0 0 0 0 0 0 0 0 0 0 0 0 0 0 0 0 0 0 0 0 0 0 0 
0 0 0 0 0 0 0 0 19 0 0 19 0 0 10 0 0 0 0 0 0 0 0 0 0 
6 2 0
